1111111111111111111111111111111111111111
1111111111111111111111111111111111111111
11EI              IEEEEI              11
11EI              IEEEEI              11
11EI              IEEEEI              11
11EI              IEEEEI              11
11EI                                  11
11EI                           1111   11
11EI    IEI                    1111   11
11EI    IEI                    1111   11
11EI    IEI                    1111   11
11EI    IEI                    1111   11
11EI    IEI                    1111   11
11EI    IEI                    1111   11
11EI    IEI                    1111   11
11EI    IEI                    1111   11
11EI    IEI                    1111   11
11EI    IEI                    1111   11
11EI    IEI                    1111   11
11EI    IEI                    1111   11
11EI    IEI                    1111   11
11EI    IEI                    1111   11
11EI    IEI                    1111   11
11EI    IEI                    1111   11
11EI    ISSSSSSSSSSSSSSSSSSSSSS1111   11
11P      00000000000000000000001111  F11
11       11111111111111111111111111   11
11       11111111111111111111111111   11
1100000001111111111111111111111111100011
1111111111111111111111111111111111111111