1111111111111111111111111111111111111111
1111111111111111111111111111111111111111
11                          11        11
11                          11        11
11                          11        11
11                          11        11
11                          11        11
11                          11        11
11            E             11        11
11000                                 11
11111                                 11
11111                                 11
11              000000000000          11
11              11                    11
11              11                    11
11              11                    11
11              11    E       E       11
11                 SS                 11
11                 00                 11
11                 11                 11
11                 11                 11
11000              11                 11
11111              11                 11
11                 11                 11
11                 11                 11
11P                11        F        11
11             000000                 11
11    E        111111                 11
1100000000000000000000000000000000000011
1111111111111111111111111111111111111111