1111111111111111111111111111111111111111
1111111111111111111111111111111111111111
11                                    11
11                                    11
11                                    11
11          E          E              11
11                                    11
11                                    11
11      E        E          E         11
11                                    11
11                                    11
11                                    11
11           0000                     11
11     E     1111       E         E   11
11           1111                     11
11           1111                     11
11                                    11
11    E         ISSSS                 11
11               0000                 11
11               1111                 11
11               1111                 11
11 E             1111        E        11
11               1111                 11
11               1111                 11
11               1111                 11
11             P 1111                F11
11               1111                 11
11               1111  SSSS     SSSS  11
1100000000000000011110000000000000000011
1111111111111111111111111111111111111111