1111111111111111111111111111111111111111
1111111111111111111111111111111111111111
11                                    11
11                                    11
11         SS                         11
11         00                         11
11         11                         11
11         11                         11
11         11                         11
11         11                         11
11         11                         11
11         11                         11
11         11                         11
11         11                         11
11         11                         11
11         11                         11
11         11                         11
11         11                         11
11         11                         11
11         11    SS                   11
11         11    11                   11
11               11                   11
11                        SSSSSSSSSSSS11
11                        00000000000011
11                        11111111111111
11P                            F      11
11                                    11
11      SSSS      SSSS           SSSSS11
1100000000000000000000000000000000000011
1111111111111111111111111111111111111111