1111111111111111111111111111111111111111
1111111111111111111111111111111111111111
11                          11        11
11                          11        11
11                          11        11
11                          11        11
11                          11        11
11                          11        11
11                          11        11
11000                                 11
11111                                 11
11111                                 11
11              000000000000          11
11              11                    11
11              11                    11
11              11                    11
11              11                    11
11           000                      11
11           111                      11
11           111                      11
11           111                      11
11000        111                      11
11111        111                      11
11           111                      11
11        000111                      11
11P                          F        11
11                                    11
11    SSSSSSSSSSSSSSS                 11
1100000000000000000000000000000000000011
1111111111111111111111111111111111111111