1111111111111111111111111111111111111111
1111111111111111111111111111111111111111
11                                    11
11                                    11
11                                    11
11                                    11
11                                    11
11                                    11
11                                    11
11           SSSSSSSSSSSSS            11
11           0000000000000            11
11           1111111111111            11
11           1111111111111          SS11
11SS         1111111111111          0011
1100         1111111111111          1111
1111         1111111111111            11
11           1111111111111            11
11           1111111111111            11
11           1111111111111SS          11
11           111111111111100          11
11           111111111111111          11
11           1111111111111            11
11         SS1111111111111            11
11         001111111111111            11
11         111111111111111            11
11P          1111111111111   F        11
11           1111111111111            11
11           1111111111111            11
1100000000000111111111111100000000000011
1111111111111111111111111111111111111111