1111111111111111111111111111111111111111
1111111111111111111111111111111111111111
11                                    11
11                                    11
11                                    11
11          SS                        11
11          00          E             11
11          11                        11
11                                    11
11                                    11
11                                    11
11                   E          E     11
11                                    11
11                                    11
11                                    11
11                                    11
11          S                         11
11          000000     E              11
11          111111                    11
11  E   I   111111                    11
11          111111                    11
11          111111                    11
11      000011        E       E       11
11      1111                          11
11      1111                          11
11P     1111F                         11
11      1111                          11
11      1111      SSSSSS              11
1100000000000000000000000000000000000011
1111111111111111111111111111111111111111